"filename", "language", "Markdown", "JSON", "CSS", "HTML", "JavaScript", "comment", "blank", "total"
"/home/mcw/Desktop/northcoders/mcwake-dev/frontend/nc-news/README.md", "Markdown", 38, 0, 0, 0, 0, 0, 33, 71
"/home/mcw/Desktop/northcoders/mcwake-dev/frontend/nc-news/design/wireframe.css", "CSS", 0, 0, 41, 0, 0, 0, 10, 51
"/home/mcw/Desktop/northcoders/mcwake-dev/frontend/nc-news/design/wireframe.html", "HTML", 0, 0, 0, 315, 0, 0, 2, 317
"/home/mcw/Desktop/northcoders/mcwake-dev/frontend/nc-news/package-lock.json", "JSON", 0, 29330, 0, 0, 0, 0, 1, 29331
"/home/mcw/Desktop/northcoders/mcwake-dev/frontend/nc-news/package.json", "JSON", 0, 42, 0, 0, 0, 0, 1, 43
"/home/mcw/Desktop/northcoders/mcwake-dev/frontend/nc-news/public/index.html", "HTML", 0, 0, 0, 33, 0, 23, 1, 57
"/home/mcw/Desktop/northcoders/mcwake-dev/frontend/nc-news/public/manifest.json", "JSON", 0, 25, 0, 0, 0, 0, 1, 26
"/home/mcw/Desktop/northcoders/mcwake-dev/frontend/nc-news/src/api/articles.js", "JavaScript", 0, 0, 0, 0, 66, 0, 25, 91
"/home/mcw/Desktop/northcoders/mcwake-dev/frontend/nc-news/src/api/comments.js", "JavaScript", 0, 0, 0, 0, 18, 0, 7, 25
"/home/mcw/Desktop/northcoders/mcwake-dev/frontend/nc-news/src/api/constants.js", "JavaScript", 0, 0, 0, 0, 14, 1, 1, 16
"/home/mcw/Desktop/northcoders/mcwake-dev/frontend/nc-news/src/api/topics.js", "JavaScript", 0, 0, 0, 0, 7, 0, 4, 11
"/home/mcw/Desktop/northcoders/mcwake-dev/frontend/nc-news/src/api/users.js", "JavaScript", 0, 0, 0, 0, 7, 0, 3, 10
"/home/mcw/Desktop/northcoders/mcwake-dev/frontend/nc-news/src/components/App/App.module.css", "CSS", 0, 0, 0, 0, 0, 0, 2, 2
"/home/mcw/Desktop/northcoders/mcwake-dev/frontend/nc-news/src/components/App/App.test.js", "JavaScript", 0, 0, 0, 0, 7, 0, 2, 9
"/home/mcw/Desktop/northcoders/mcwake-dev/frontend/nc-news/src/components/App/index.js", "JavaScript", 0, 0, 0, 0, 30, 0, 4, 34
"/home/mcw/Desktop/northcoders/mcwake-dev/frontend/nc-news/src/components/Article/index.js", "JavaScript", 0, 0, 0, 0, 27, 0, 6, 33
"/home/mcw/Desktop/northcoders/mcwake-dev/frontend/nc-news/src/components/ArticleCard/ArticleCard.module.css", "CSS", 0, 0, 36, 0, 0, 0, 8, 44
"/home/mcw/Desktop/northcoders/mcwake-dev/frontend/nc-news/src/components/ArticleCard/index.js", "JavaScript", 0, 0, 0, 0, 82, 0, 5, 87
"/home/mcw/Desktop/northcoders/mcwake-dev/frontend/nc-news/src/components/ArticleControls/ArticleControls.module.css", "CSS", 0, 0, 31, 0, 0, 0, 6, 37
"/home/mcw/Desktop/northcoders/mcwake-dev/frontend/nc-news/src/components/ArticleControls/index.js", "JavaScript", 0, 0, 0, 0, 117, 0, 8, 125
"/home/mcw/Desktop/northcoders/mcwake-dev/frontend/nc-news/src/components/ArticleList/ArticleList.module.css", "CSS", 0, 0, 14, 0, 0, 0, 2, 16
"/home/mcw/Desktop/northcoders/mcwake-dev/frontend/nc-news/src/components/ArticleList/index.js", "JavaScript", 0, 0, 0, 0, 37, 0, 6, 43
"/home/mcw/Desktop/northcoders/mcwake-dev/frontend/nc-news/src/components/CommentCard/CommentCard.module.css", "CSS", 0, 0, 25, 0, 0, 0, 5, 30
"/home/mcw/Desktop/northcoders/mcwake-dev/frontend/nc-news/src/components/CommentCard/index.js", "JavaScript", 0, 0, 0, 0, 54, 0, 4, 58
"/home/mcw/Desktop/northcoders/mcwake-dev/frontend/nc-news/src/components/CommentForm/CommentForm.module.css", "CSS", 0, 0, 4, 0, 0, 0, 1, 5
"/home/mcw/Desktop/northcoders/mcwake-dev/frontend/nc-news/src/components/CommentForm/index.js", "JavaScript", 0, 0, 0, 0, 52, 0, 7, 59
"/home/mcw/Desktop/northcoders/mcwake-dev/frontend/nc-news/src/components/CommentList/CommentList.module.css", "CSS", 0, 0, 0, 0, 0, 0, 2, 2
"/home/mcw/Desktop/northcoders/mcwake-dev/frontend/nc-news/src/components/CommentList/index.js", "JavaScript", 0, 0, 0, 0, 46, 0, 6, 52
"/home/mcw/Desktop/northcoders/mcwake-dev/frontend/nc-news/src/components/Layout/Layout.module.css", "CSS", 0, 0, 56, 0, 0, 0, 8, 64
"/home/mcw/Desktop/northcoders/mcwake-dev/frontend/nc-news/src/components/Layout/index.js", "JavaScript", 0, 0, 0, 0, 46, 0, 3, 49
"/home/mcw/Desktop/northcoders/mcwake-dev/frontend/nc-news/src/components/Loading/Loading.module.css", "CSS", 0, 0, 32, 0, 0, 1, 5, 38
"/home/mcw/Desktop/northcoders/mcwake-dev/frontend/nc-news/src/components/Loading/index.js", "JavaScript", 0, 0, 0, 0, 30, 0, 5, 35
"/home/mcw/Desktop/northcoders/mcwake-dev/frontend/nc-news/src/components/NewArticle/NewArticle.module.css", "CSS", 0, 0, 21, 0, 0, 0, 5, 26
"/home/mcw/Desktop/northcoders/mcwake-dev/frontend/nc-news/src/components/NewArticle/index.js", "JavaScript", 0, 0, 0, 0, 71, 0, 8, 79
"/home/mcw/Desktop/northcoders/mcwake-dev/frontend/nc-news/src/components/NotFound/NotFound.module.css", "CSS", 0, 0, 16, 0, 0, 0, 3, 19
"/home/mcw/Desktop/northcoders/mcwake-dev/frontend/nc-news/src/components/NotFound/index.js", "JavaScript", 0, 0, 0, 0, 19, 0, 4, 23
"/home/mcw/Desktop/northcoders/mcwake-dev/frontend/nc-news/src/components/SortAndFilterLink/SortAndFilterLink.module.css", "CSS", 0, 0, 8, 0, 0, 0, 2, 10
"/home/mcw/Desktop/northcoders/mcwake-dev/frontend/nc-news/src/components/SortAndFilterLink/index.js", "JavaScript", 0, 0, 0, 0, 36, 0, 6, 42
"/home/mcw/Desktop/northcoders/mcwake-dev/frontend/nc-news/src/components/TopicBanner/TopicBanner.module.css", "CSS", 0, 0, 12, 0, 0, 0, 1, 13
"/home/mcw/Desktop/northcoders/mcwake-dev/frontend/nc-news/src/components/TopicBanner/index.js", "JavaScript", 0, 0, 0, 0, 9, 0, 3, 12
"/home/mcw/Desktop/northcoders/mcwake-dev/frontend/nc-news/src/components/TopicSelect/index.js", "JavaScript", 0, 0, 0, 0, 30, 0, 6, 36
"/home/mcw/Desktop/northcoders/mcwake-dev/frontend/nc-news/src/components/UserCard/UserCard.module.css", "CSS", 0, 0, 52, 0, 0, 0, 8, 60
"/home/mcw/Desktop/northcoders/mcwake-dev/frontend/nc-news/src/components/UserCard/index.js", "JavaScript", 0, 0, 0, 0, 44, 0, 4, 48
"/home/mcw/Desktop/northcoders/mcwake-dev/frontend/nc-news/src/components/UserList/UserList.module.css", "CSS", 0, 0, 0, 0, 0, 0, 1, 1
"/home/mcw/Desktop/northcoders/mcwake-dev/frontend/nc-news/src/components/UserList/index.js", "JavaScript", 0, 0, 0, 0, 30, 0, 4, 34
"/home/mcw/Desktop/northcoders/mcwake-dev/frontend/nc-news/src/components/VoteControls/VoteControls.module.css", "CSS", 0, 0, 24, 0, 0, 0, 5, 29
"/home/mcw/Desktop/northcoders/mcwake-dev/frontend/nc-news/src/components/VoteControls/index.js", "JavaScript", 0, 0, 0, 0, 43, 0, 9, 52
"/home/mcw/Desktop/northcoders/mcwake-dev/frontend/nc-news/src/index.css", "CSS", 0, 0, 8, 0, 0, 0, 1, 9
"/home/mcw/Desktop/northcoders/mcwake-dev/frontend/nc-news/src/index.js", "JavaScript", 0, 0, 0, 0, 13, 0, 3, 16
"/home/mcw/Desktop/northcoders/mcwake-dev/frontend/nc-news/src/setupTests.js", "JavaScript", 0, 0, 0, 0, 1, 4, 1, 6
"Total", "-", 38, 29397, 380, 348, 936, 29, 258, 31386